# 繁簡名詞對照表 (OpenCC user phrases format)
# 格式: 簡體/中國用語<TAB>繁體/台灣用語
# 注意: 先轉換長詞，避免被短詞截斷

# 軟體/技術類
视频处理	影片處理
视频文件	影片檔案
视频效果	影片效果
视频合成	影片合成
视频编辑	影片編輯
视频	影片
視頻	影片
音频文件	音訊檔案
音频	音訊
音頻	音訊
数据库	資料庫
数据流	資料流
数据	資料
數據	資料
接口	介面
人工智能	人工智慧
智能	智慧
默认值	預設值
默认	預設
文件夹	資料夾
文件	檔案
目录	目錄
网络	網路
程序	程式
用户	使用者
账号	帳號
日志	紀錄
服务器	伺服器
屏幕	螢幕
软件	軟體
硬件	硬體
信息	資訊
支持	支援

# 文檔類
文档	文件
运营	營運

# 動畫/效果類
动画	動畫
渲染	渲染
帧率	幀率
帧	幀

# 配置類
配置文件	設定檔
配置	設定
组件	元件
模块	模組
参数	參數
变量	變數
